45
13
./textures/map.tga
./textures/breakable_cube.tga
111111111111111111111111111111111111111111111
100000000000002200000000000002200000000000001
101212121212102201212121212102201212121212101
102020202020202202020202020202202020202020201
101212121212102201212121212102201212121212101
102020202020202202020202020202202020202020201
101212121212102201212121212102201212121212101
102020202020202202020202020202202020202020201
101212121212102201212121212102201212121212101
102020202020202202020202020202202020202020201
101212121212102201212121212102201212121212101
100000000000002200000000000002200000000000001
111111111111111111111111111111111111111111111
