42
27
./textures/map.tga
./textures/breakable_cube.tga
111111111111111111111111111111111111111111
100000000000000000000000000000000000000001
100000000000000000000000000000000000000001
100011000110000022112211220000011000110001
100001100110000022112211220000001100110001
100001100110000000000000110000001100110001
100000110110000000000000110000000110110001
100000011110000022112211220000000011110001
100000011110000022112211220000000011110001
100000110110000000000000110000000110110001
100001100110000000000000110000001100110001
100001100110000022112211220000001100110001
100011000110000022112211220000011000110001
100000000000000000000000000000000000000001
100000000110000000111110000000001100000001
100000000110000001111111000000001100000001
100000000110000011000001100000001100000001
100000000110000022000002200000001100000001
100000000110000022000002200000001100000001
100111111110000022000002200000001100000001
101100000110000022000002200000001100000001
101100000110000011000001100000001100000001
101100000110000001100011000111111111111001
100111111110000000111110000111111111111001
100000000000000000000000000000000000000001
100000000000000000000000000000000000000001
111111111111111111111111111111111111111111
